###################
#p#..............d#
#.#.###.#.#########
#...#...#.........#
#.###.#########.#.#
#.#d..#.......#d#.#
#d#####.#####.###.#
#...#.......#.#...#
###.#.#####.#.#.#.#
#d..#.#...#d#...#d#
###.#.#.#.#########
#...#...#.##...####
#.#######.#..#.##d#
#.......#.#.##....#
#####.#.#.#.#####.#
#..d#.#.#...#...#.#
#.###.#.#####.#.#.#
#.....#.......#d#d#
###################